11111
1E001
1C001
1P001
11111
